m m s m m m m m m m m m m m m
m f f f f f f m f m f f f f m
m f m m f m m m f f f m m f m
m f f f f f f f f m f f m f m
m f m m m m f m m m m f m f m
m f f f m f f f f f f f m f m
m f m f m m m m m m f m m f m
m f m f f f f f f f f f m m m
m f m f m f m m m f m f f f m
m f m f f f m f f f m f m f m
m f m m m f m f m m m f m f m
m m f f f f m f f m f f m m m
m m f m m m m f m m m m m f m
m f f m f f f f f f f f f f m
m m o m m m m m m m m m m m m